NO textures/cobblestone.xpm
SO textures/red_brick.xpm
WE textures/mossy_cobblestone1.xpm
EA textures/cobblestone_02.xpm

C 157 , 198, 239
F 25, 67, 24

111111111111111111111
10W000000000000000001
101011111010101110101
111111111111111111111
10000000000000000
1000000000000
