1111111111111111111
1C0E000000C00000P01
1111111111111111111
