1111111111111111111111111111
1E0000000100000C00000C010001
1010101101000000111001110101
1010100101011100001000010101
1P001001C00C01000010000001C1
1111111111111111111111111111
