111111111
1E00100P1
100C01001
10000C001
111111111
