1111111111
1P00CC00E1
1111111111
