111111111111111111111111111111
1P0001010101010101010101010101
111101110111011101110111011101
100000000001000100010001000101
101111011111110111111101111011
101001000000010100000101000001
101011111111011111110111111101
101010000001000000001010000001
101010111101111111011111110101
101010100001000000101000001001
101010101111111110111111101111
101010101000000010100000101001
101010101011111011111101111011
101010101010001010000010100001
101010101010111011111011111111
101010101010100010000010000001
101010101010101111111011111111
101010101010101000001010000001
101010101010101011101111111101
101010101010101010001000000001
101010101010101010111111111101
101010101010101010100000000101
101010101010101010101111110101
101010101010101010101000010101
101010101010101010101011010101
101010101010101010101010010101
101010101010101010101010110101
101010101010101010101010100101
101010101010101010101010101101
100C00100010000000000000000E01
111111111111111111111111111111
